00,00,00,00,00,00,00,00,00,00,
00,05,04,04,04,04,04,04,03,00,
00,12,12,12,12,12,12,12,12,00,
00,26,26,26,26,26,26,26,26,00,
00,26,26,26,26,26,26,26,26,00,
00,26,26,26,26,26,26,26,26,00,
00,26,26,26,26,26,26,26,26,00,
00,26,26,26,26,26,26,26,26,00,
00,00,00,00,00,00,00,00,00,00,
00,00,00,00,00,00,00,00,00,00,

00,00,00,00,00,00,00,00,00,00,
25,25,25,25,25,25,25,25,25,25,
25,00,00,00,00,00,00,00,00,25,
25,00,00,00,00,00,00,00,00,25,
25,00,00,00,00,00,00,00,00,25,
25,00,00,25,00,00,00,00,00,25,
25,00,00,00,00,00,00,00,00,25,
25,00,00,00,00,00,00,00,00,25,
25,00,00,00,00,00,00,00,00,25,
25,25,25,25,25,25,25,25,25,25,

00,00,00,00,00,00,00,00,00,00,
00,00,00,00,00,00,00,00,00,00,
00,08,00,00,00,00,00,00,09,00,
00,08,00,00,00,00,00,00,09,00,
00,08,00,00,00,00,00,00,09,00,
00,08,00,00,00,00,00,00,09,00,
00,08,00,00,00,00,00,00,09,00,
00,20,04,04,04,04,04,04,19,00,
00,01,01,01,01,01,01,01,01,00,
00,00,00,00,00,00,00,00,00,00,